XXXXXXXXXXXXXXX
Xa   FFFF     X
X OFOFOFO OFO X
X  FFF   F  FFX
X O OFO O O O X
X  FF F    F  X
X OFO OFO OFO X
X        FF  FX
X OFO O O O O X
X FF  FFFF  F X
XXXXXXXXXXXXXXX