XXXXXXXXXXXXXXX
Xa   FFFF e   X
X OFOFOFO OFO X
X  FFF   F  FFX
X O OFO O O O X
X  FF F d  F  X
X OFO OFO OFO X
X  c f   FF  FX
X OFO O O O O X
X FF  FFFF  FbX
XXXXXXXXXXXXXXX